Mit	ADP
ihrer	DET
R	NOUN
&	SYM
B	NOUN
-	PUNCT
ähnlichen	ADJ
Musik	NOUN
prägt	VERB
sie	PRON
derzeit	ADV
eine	DET
ganze	ADJ
Generation	NOUN
an	ADP
jungen	ADJ
albanischen	ADJ
Sängern	NOUN
und	CCONJ
Sängerinnen	NOUN
.	PUNCT

Derzeit	ADV
hält	VERB
die	DET
Telekom-Tochter	NOUN
25	NUM
Prozent	NOUN
an	ADP
Infoseek	PROPN
,	PUNCT
der	DET
offiziellen	ADJ
Suchmaschine	NOUN
von	ADP
T-Online	PROPN
,	PUNCT
die	PRON
auf	ADP
diversen	ADJ
Portalseiten	NOUN
des	DET
Providers	NOUN
integriert	VERB
ist	AUX
.	PUNCT

Der	DET
Chipsatz	NOUN
besteht	VERB
aus	ADP
der	DET
Northbridge	PROPN
M1641	X
und	CCONJ
der	DET
Southbridge	PROPN
M1535	X
.	PUNCT

Richtig	ADJ
,	PUNCT
wir	PRON
sind	AUX
im	ADP
Reich	NOUN
der	DET
Werbung	NOUN
gelandet	VERB
,	PUNCT
und	CCONJ
zwar	ADV
mitten	ADV
im	ADP
ersten	ADJ
interaktiven	ADJ
Pinkelbecken	NOUN
.	PUNCT

Auf	ADP
diese	DET
Weise	NOUN
müsse	AUX
sicher	ADP
gestellt	VERB
werden	AUX
,	PUNCT
dass	SCONJ
vor	ADP
allem	PRON
die	DET
militärischen	ADJ
und	CCONJ
inneren	ADJ
Sicherheitsstrukturen	NOUN
nicht	PART
gestört	VERB
werden	AUX
können	AUX
.	PUNCT

Mit	ADP
seinem	PRON
interaktiven	ADJ
Eve-Adventure	NOUN
und	CCONJ
dem	DET
ins	ADP
Mainstream	NOUN
pendelnden	ADJ
Ovo	PROPN
ist	AUX
der	DET
Mann	NOUN
im	ADP
Internet	NOUN
präsent	ADJ
,	PUNCT
doch	CCONJ
nein	INTJ
:	PUNCT
