دراسة	NOUN
:	PUNCT
العنف	NOUN
المنزلي	ADJ
في	ADP
الولايات	NOUN
المتحدة	ADJ
يطال	VERB
25	NUM
%	SYM
من	ADP
النساء	NOUN
و	CCONJ
7،5	NUM
من	ADP
الرجال	NOUN

واعلن	CCONJ
شافيز	X
ان	CCONJ
سلطنة	NOUN
عمان	NOUN
وروسيا	X
والنروج	PROPN
يمكن	VERB
ان	CCONJ
تدخل	VERB
منظمة	NOUN
اوبك	X
خلال	ADP
القمة	NOUN
المقبلة	ADJ
لرؤساء	NOUN
دول	NOUN
المنظمة	NOUN
المقررة	ADJ
في	ADP
كراكاس	X
في	ADP
ايلول	NOUN
/	PUNCT
سبتمبر	NOUN
المقبل	ADJ
.	PUNCT

وأضاف	CCONJ
:	PUNCT
»	PUNCT
صدرنا	NOUN
لن	PART
يضيق	VERB
بأحد	NOUN
فمرحباً	INTJ
بالمبادرات	NOUN
والأشقاء	NOUN
والجوار	NOUN
والعالم	NOUN
القاصي	ADJ
والداني	ADJ
من	ADP
اجل	NOUN
الاستقرار	NOUN
وتبادل	NOUN
المنافع	NOUN
،	PUNCT
ولكن	CCONJ
ليس	VERB
على	ADP
حساب	NOUN
مبادئنا	NOUN
ولا	PART
ينتظر	VERB
منا	PRON
أحد	NOUN
ان	CCONJ
نفرط	X
في	ADP
أمانة	NOUN
أو	CCONJ
حق	NOUN
مهر	X
بالدماء	NOUN
والمهج	NOUN
والأرواح	NOUN
«	PUNCT
.	PUNCT

وذكر	CCONJ
أنه	CCONJ
ليست	AUX
هناك	ADV
مشكلة	NOUN
في	ADP
موضوع	NOUN
سعر	NOUN
صرف	NOUN
الجنيه	NOUN
المصري	ADJ
،	PUNCT
معتبراً	ADJ
ان	CCONJ
ثبات	NOUN
سعر	NOUN
الصرف	NOUN
هو	PRON
الخطأ	NOUN
،	PUNCT
وان	CCONJ
الحكومة	NOUN
المصرية	ADJ
ستترك	VERB
الموضوع	NOUN
لقوى	NOUN
العرض	NOUN
والطلب	NOUN
كما	CCONJ
يحدث	VERB
في	ADP
دول	NOUN
العالم	NOUN
الأخرى	ADJ
.	PUNCT
وأشار	VERB
إلى	ADP
أن	CCONJ
هناك	ADV
حالياً	ADJ
سياسة	NOUN
ثابتة	ADJ
في	ADP
مصر	NOUN
لسعر	NOUN
الصرف	NOUN
يدور	VERB
حول	ADP
4.25	NUM
قرش	NOUN
مع	ADP
تركه	NOUN
يتحرك	VERB
ثلاثة	NUM
في	ADP
المئة	NUM
صعوداً	NOUN
او	CCONJ
نزولاً	NOUN
.	PUNCT

وبدأ	CCONJ
المبعوث	NOUN
الرئاسي	ADJ
الاميركي	ADJ
جون	X
دانفورث	X
أمس	ADV
محادثات	NOUN
مع	ADP
كبار	ADJ
المسؤولين	NOUN
السودانيين	ADJ
تزامنت	VERB
مع	ADP
بدء	NOUN
مفاوضات	NOUN
مباشرة	ADJ
بين	ADP
وفدين	NOUN
رفيعي	ADJ
المستوى	NOUN
من	ADP
الحكومة	NOUN
السودانية	ADJ
و	CCONJ
»	PUNCT
الحركة	NOUN
الشعبية	ADJ
لتحرير	NOUN
السودان	NOUN
«	PUNCT
في	ADP
سويسرا	X
تحت	ADP
رعاية	NOUN
أميركية	ADJ
.	PUNCT
(	PUNCT
راجع	VERB
ص	X
٥	NUM
)	PUNCT
.	PUNCT
ورفض	VERB
المسؤولون	NOUN
السويسريون	ADJ
تحديد	NOUN
مكان	NOUN
الاجتماع	NOUN
أو	CCONJ
كشف	NOUN
أسماء	NOUN
المشاركين	NOUN
فيه	PRON
.	PUNCT
وعلمت	VERB
»	PUNCT
الحياة	NOUN
«	PUNCT
أن	CCONJ
وكيل	NOUN
وزارة	NOUN
الخارجية	NOUN
الدكتور	NOUN
مطرف	X
صديق	X
يرأس	VERB
وفد	NOUN
الحكومة	NOUN
الذي	DET
يضم	VERB
يحيي	X
حسين	X
وصلاح	NOUN
عبدالله	PROPN
والعميد	NOUN
محمد	X
الشيخ	X
التوم	X
،	PUNCT
فيما	CCONJ
يقود	VERB
وفد	NOUN
»	PUNCT
الحركة	NOUN
الشعبية	ADJ
«	PUNCT
عبدالعزيز	PROPN
الحلو	X
ويشارك	VERB
فيه	PRON
دينغ	X
ألور	X
ونيال	PROPN
دينغ	X
وياسر	NOUN
عرمان	X
.	PUNCT

ومتى	CCONJ
ينادي	VERB
الإخوان	NOUN
حي	INTJ
على	ADP
الجهاد	NOUN
؟	PUNCT
"	PUNCT
.	PUNCT

كما	CCONJ
ارتفعت	VERB
الصادرات	NOUN
من	ADP
المواد	NOUN
الكيماوية	NOUN
والأدوية	NOUN
والمستلزمات	NOUN
الطبية	ADJ
بنسبة	NOUN
21	NUM
%	SYM
لتصل	VERB
إلى	ADP
299	NUM
مليون	NUM
دولار	NOUN
،	PUNCT
نتيجة	NOUN
زيادة	NOUN
الصادرات	NOUN
من	ADP
راتنجات	X
ولدائن	NOUN
صناعية	ADJ
،	PUNCT
ومنتجات	NOUN
كيماوية	NOUN
عضوية	ADJ
وغير	NOUN
عنصرية	ADJ
.	PUNCT

ولفت	CCONJ
خبراء	NOUN
ومحللون	NOUN
إلى	ADP
أن	CCONJ
مبارك	X
لم	PART
يتحدث	VERB
يوماً	NOUN
بطريقة	NOUN
توحي	VERB
بأنه	PRON
يؤيد	VERB
توريث	NOUN
الحكم	NOUN
لابنه	NOUN
،	PUNCT
مما	CCONJ
يرجح	VERB
أن	CCONJ
مثل	ADP
هذا	DET
الاتجاه	NOUN
قد	PART
يكون	AUX
مدعوماً	ADJ
من	ADP
بعض	NOUN
المحيطين	ADJ
به	PRON
.	PUNCT

تلقى	VERB
وزير	NOUN
الخارجية	NOUN
المصرى	ADJ
احمد	X
ماهر	X
هنا	X
مساء	X
اليوم	NOUN
الاحد	X
اتصالا	NOUN
هاتفيا	ADJ
من	ADP
نظيره	NOUN
الفلسطينى	NOUN
نبيل	X
شعث	X
لتنسيق	NOUN
المواقف	NOUN
بين	ADP
الطرفين	NOUN
بشأن	ADP
القضية	NOUN
الفلسطينية	NOUN
وذلك	CCONJ
قبيل	ADP
زيارة	NOUN
وزير	NOUN
الخارجية	NOUN
الأمريكى	ADJ
كولين	X
باول	X
لمصر	NOUN
فى	ADP
اعقاب	X
زيارة	NOUN
إسرائيل	X
والاراضى	NOUN
الفلسطينية	ADJ
.	PUNCT
