فقد	CCONJ
تعهد	VERB
الرئيس	NOUN
الكوري	ADJ
الجنوبي	ADJ
كيم	X
داي	X
-	PUNCT
جونغ	X
ورئيس	NOUN
كوريا	X
الشمالية	ADJ
كيم	X
جونغ	X
-	PUNCT
ايل	X
انذاك	ADV
بطي	NOUN
صفحة	NOUN
نصف	NOUN
قرن	NOUN
من	ADP
العداء	NOUN
والسعي	NOUN
الى	ADP
اعادة	NOUN
توحيد	NOUN
البلاد	NOUN
.	PUNCT

وتجري	CCONJ
شركة	NOUN
+	SYM
ميغ	X
+	SYM
ايضا	ADV
مفاوضات	NOUN
مع	ADP
النمسا	X
لتزويد	NOUN
اسطولها	NOUN
الجوي	ADJ
بطائرات	NOUN
ميغ	X
-	PUNCT
29	NUM
اس	X
.	PUNCT
ام	X
.	PUNCT
تي	X
المجهزة	ADJ
بأحدث	ADJ
الانظمة	NOUN
الدفاعية	ADJ
والمزودة	ADJ
بخزان	NOUN
اضافي	ADJ
للمحروقات	ADJ
وبجهاز	NOUN
تحكم	NOUN
الكتروني	ADJ
حديث	ADJ
.	PUNCT

يذكر	VERB
ان	CCONJ
90	NUM
%	SYM
من	ADP
سكان	NOUN
اندونيسيا	X
(	PUNCT
210	NUM
ملايين	NUM
نسمة	NOUN
)	PUNCT
من	ADP
المسلمين	NOUN
،	PUNCT
واندونيسيا	CCONJ
هي	PRON
رابع	ADJ
دولة	NOUN
في	ADP
العالم	NOUN
من	ADP
حيث	CCONJ
كثافة	NOUN
السكان	NOUN
.	PUNCT

وكان	CCONJ
السيد	NOUN
عبد	X
الباقي	X
باشا	X
رئيس	NOUN
الاتحاد	NOUN
التونسي	ADJ
للفلاحة	NOUN
والصيد	NOUN
البحري	ADJ
اكد	VERB
في	ADP
كلمته	NOUN
ان	CCONJ
يوم	NOUN
24	NUM
اكتوبر	NOUN
سيكون	AUX
مناسبة	NOUN
يجدد	VERB
فيها	PRON
التونسيون	ADJ
تعلقهم	NOUN
بخيارات	NOUN
الرئيس	NOUN
زين	X
العابدين	NOUN
بن	PROPN
علي	X
والتعبير	NOUN
عن	ADP
مشاعر	NOUN
العرفان	NOUN
والجميل	NOUN
لسيادته	NOUN
لما	DET
حققته	VERB
تونس	X
في	ADP
ظل	NOUN
قيادته	NOUN
الحكيمة	ADJ
من	ADP
مكاسب	NOUN
وانجازات	NOUN
هي	PRON
مبعث	NOUN
فخر	NOUN
واعتزاز	NOUN
كل	NOUN
التونسيين	ADJ
ومصدر	NOUN
اعجاب	NOUN
وتقدير	NOUN
البلدان	NOUN
الشقيقة	ADJ
والصديقة	NOUN
والهيئات	NOUN
والمؤسسات	NOUN
الاقليمية	ADJ
والدولية	ADJ
.	PUNCT

وقال	CCONJ
عبدالحي	PROPN
مطمئن	X
لوكالة	NOUN
»	PUNCT
رويترز	X
«	PUNCT
من	ADP
مدينة	NOUN
قندهار	X
في	ADP
جنوب	NOUN
افغانستان	X
:	PUNCT
»	PUNCT
ما	DET
حدث	VERB
في	ADP
الولايات	NOUN
المتحدة	ADJ
ليس	AUX
مهمة	NOUN
يقوم	VERB
بها	PRON
اناس	X
عاديون	ADJ
.	PUNCT
قد	PART
تكون	AUX
من	ADP
عمل	NOUN
الحكومات	NOUN
.	PUNCT
.	PUNCT
اسامة	X
بن	PROPN
لادن	X
لا	PART
يمكنه	VERB
عمل	NOUN
ذلك	DET
.	PUNCT
.	PUNCT
ولا	PART
نحن	X
.	PUNCT
.	PUNCT
.	PUNCT
نحن	X
لا	PART
ندعم	X
الارهاب	NOUN
.	PUNCT
.	PUNCT
واسامة	NOUN
لا	PART
يمـــلك	VERB
القـــدرة	NOUN
.	PUNCT
.	PUNCT
ونحـــن	PRON
ندين	X
ذلك	X
.	PUNCT
.	PUNCT
ربمــا	PART
يكون	AUX
هذا	X
من	ADP
عمل	NOUN
اعداء	X
داخليين	ADJ
للولايات	NOUN
المتحدة	ADJ
او	CCONJ
منافسيها	NOUN
الكبار	ADJ
.	PUNCT
.	PUNCT
اســامة	X
لا	PART
يمكنه	VERB
عمل	NOUN
ذلك	DET
«	PUNCT
.	PUNCT

وأضاف	CCONJ
:	PUNCT
»	PUNCT
صدرنا	NOUN
لن	PART
يضيق	VERB
بأحد	NOUN
فمرحباً	INTJ
بالمبادرات	NOUN
والأشقاء	NOUN
والجوار	NOUN
والعالم	NOUN
القاصي	ADJ
والداني	ADJ
من	ADP
اجل	NOUN
الاستقرار	NOUN
وتبادل	NOUN
المنافع	NOUN
،	PUNCT
ولكن	CCONJ
ليس	VERB
على	ADP
حساب	NOUN
مبادئنا	NOUN
ولا	PART
ينتظر	VERB
منا	PRON
أحد	NOUN
ان	CCONJ
نفرط	X
في	ADP
أمانة	NOUN
أو	CCONJ
حق	NOUN
مهر	X
بالدماء	NOUN
والمهج	NOUN
والأرواح	NOUN
«	PUNCT
.	PUNCT

وأفادت	CCONJ
مصادر	NOUN
في	ADP
»	PUNCT
الجماعة	NOUN
«	PUNCT
ان	CCONJ
قوات	NOUN
الامن	NOUN
اقتحمت	VERB
فجر	NOUN
امس	ADV
منازل	NOUN
عدد	NOUN
من	ADP
قادة	NOUN
»	PUNCT
الاخوان	NOUN
«	PUNCT
في	ADP
محافظات	NOUN
القاهرة	NOUN
والقليوبية	NOUN
والجيزة	NOUN
وألقت	VERB
القبض	NOUN
عليهم	PRON
وصادرت	VERB
كتباً	NOUN
ووثائق	NOUN
بدعوى	NOUN
أنها	PRON
تمثل	VERB
أدلة	NOUN
ثبوتية	ADJ
ضدهم	PRON
تفيد	VERB
انهم	PRON
يعملون	VERB
في	ADP
إطار	NOUN
تنظيم	NOUN
سري	ADJ
مناهض	ADJ
لنظام	NOUN
الحكم	NOUN
في	ADP
البلاد	NOUN
.	PUNCT
وتضم	VERB
لائحة	NOUN
المعتقلين	NOUN
إضافة	NOUN
الى	ADP
غزلان	NOUN
الدكتور	NOUN
حسين	X
الدرج	X
وماجد	NOUN
حسن	X
رمضان	X
والدكتور	NOUN
محيي	X
الظايط	X
ورجل	NOUN
الأعمال	NOUN
طاهر	X
عبدالمنعم	PROPN
والمهندس	NOUN
اسامة	X
أبو	X
شادي	X
والدكتور	NOUN
مأمون	X
عاشور	X
وعبدالمنعم	PROPN
البربري	X
والدكتور	NOUN
أحمد	X
سعفان	X
،	PUNCT
والدكتور	NOUN
سيد	X
شبة	X
ومحمد	NOUN
محمد	X
رشاد	X
والدكتور	NOUN
محمد	X
هشام	X
عيسى	NOUN
والدكتور	NOUN
محمد	X
العبد	X
والدكتور	NOUN
محمد	X
محمود	X
منصور	X
والدكتور	NOUN
محمد	X
عزيز	X
همام	X
الزمر	X
.	PUNCT
وقالت	VERB
مصادر	NOUN
»	PUNCT
الإخوان	NOUN
«	PUNCT
لـ	ADP
»	PUNCT
الحياة	NOUN
«	PUNCT
:	PUNCT
إن	CCONJ
»	PUNCT
أجهزة	NOUN
كومبيوتر	X
تخص	VERB
الموقوفين	ADJ
صودرت	VERB
إضافة	NOUN
إلى	ADP
كتب	NOUN
مصرح	ADJ
بها	PRON
«	PUNCT
.	PUNCT

وقال	CCONJ
:	PUNCT
"	PUNCT
بلاش	INTJ
تنشر	VERB
اسمي	NOUN
.	PUNCT
.	PUNCT

وقالت	CCONJ
الحكومة	NOUN
إن	CCONJ
حصيلتها	NOUN
من	ADP
النقد	NOUN
الأجنبي	ADJ
قد	AUX
ارتفعت	VERB
في	ADP
العام	NOUN
المالي	ADJ
2002	NUM
/	PUNCT
2003	NUM
بقيمة	NOUN
1264.6	NUM
مليون	NUM
دولار	NOUN
.	PUNCT

عضو	NOUN
في	ADP
"	PUNCT
الإخوان	NOUN
"	PUNCT
يسأل	VERB
الهضيبي	X
:	PUNCT
متى	DET
ننادي	X
حي	INTJ
على	ADP
الجهاد	NOUN
!	PUNCT

ورحب	CCONJ
شيخ	NOUN
الأزهر	NOUN
بمن	DET
ينادون	VERB
بانتخاب	NOUN
شيخ	NOUN
الأزهر	NOUN
وقال	VERB
بلغة	NOUN
واثقة	ADJ
:	PUNCT
"	PUNCT
مرحباً	INTJ
بالانتخاب	NOUN
"	PUNCT
،	PUNCT
وعندما	CCONJ
سأله	VERB
المذيع	NOUN
عن	ADP
حق	NOUN
أي	ADJ
مسلم	NOUN
في	ADP
العالم	NOUN
أن	CCONJ
يرشح	VERB
نفسه	NOUN
لهذا	ADP
الموقع	NOUN
قال	VERB
شيخ	NOUN
الأزهر	NOUN
:	PUNCT
"	PUNCT
وأبناء	NOUN
العالم	NOUN
الإسلامي	ADJ
يتدخلوا	X
في	ADP
مصر	NOUN
ليه	X
؟	PUNCT
"	PUNCT
.	PUNCT

وفي	CCONJ
فبراير	NOUN
من	ADP
العام	NOUN
نفسه	NOUN
تأسس	VERB
حزب	NOUN
الفضيلة	NOUN
كامتداد	NOUN
لحزب	NOUN
الرفاه	NOUN
المحظور	ADJ
،	PUNCT
بزعامة	NOUN
رجائي	X
قوطان	X
وتراجعت	VERB
أصوات	NOUN
الحزب	NOUN
في	ADP
انتخابات	NOUN
أبريل	NOUN
1999	NUM
من	ADP
21	NUM
%	SYM
عام	NOUN
1995	NUM
إلى	ADP
15	NUM
%	SYM
.	PUNCT

أما	PART
على	ADP
مستوى	X
التراجع	NOUN
في	ADP
الأرباح	NOUN
فقد	AUX
أظهرت	VERB
نتائج	NOUN
أعمال	NOUN
بنك	NOUN
"	PUNCT
التنمية	NOUN
الصناعية	ADJ
"	PUNCT
تراجعاً	NOUN
نسبياً	ADJ
في	ADP
صافي	X
أرباحه	NOUN
بلغت	VERB
نسبته	NOUN
14	NUM
%	SYM
حيث	CCONJ
سجل	VERB
3	NUM
ملايين	NUM
جنيه	NOUN
مقارنة	NOUN
بـ	ADP
3.5	NUM
مليون	X
جنيه	NOUN
عن	ADP
العام	NOUN
المالي	ADJ
2001	NUM
/	PUNCT
2002	NUM
.	PUNCT

وكأنه	CCONJ
يقول	VERB
للمسلمين	NOUN
في	ADP
فرنسا	X
والعالم	NOUN
:	PUNCT
ليس	AUX
من	ADP
حقكم	NOUN
الاعتراض	NOUN
حتى	ADV
على	ADP
مستوى	NOUN
الحوار	NOUN
الموضوعي	ADJ
العقلاني	ADJ
مع	ADP
الدولة	NOUN
الفرنسية	ADJ
وغيرها	NOUN
أو	CCONJ
التحدث	NOUN
عن	ADP
الإسلام	NOUN
في	ADP
التزاماته	NOUN
الدينية	ADJ
،	PUNCT
بل	CCONJ
عليكم	PRON
الطاعة	NOUN
للحق	NOUN
القانوني	ADJ
حتى	ADV
لو	CCONJ
منعكم	VERB
من	ADP
الصلاة	NOUN
في	ADP
المساجد	NOUN
أو	CCONJ
الصوم	NOUN
في	ADP
شهر	NOUN
رمضان	NOUN
"	PUNCT
.	PUNCT

واعربت	CCONJ
بعض	NOUN
البلدان	NOUN
الاعضاء	NOUN
فى	ADP
الاوبك	X
عن	ADP
قلقها	ADJ
ازاء	ADP
بقاء	NOUN
الاسعار	NOUN
فى	ADP
مستوى	NOUN
اقل	ADJ
من	ADP
ال	PART
25	NUM
دولارا	NOUN
المحدد	ADJ
من	ADP
قبل	ADP
الاوبك	X
.	PUNCT
وقال	VERB
رئيس	NOUN
المنظمة	NOUN
عبدالله	PROPN
العطية	X
يوم	NOUN
الاربعاء	NOUN
الماضى	ADJ
ان	CCONJ
الاوبك	X
قلقة	ADJ
ازاء	ADP
انخفاض	NOUN
الاسعار	NOUN
وان	CCONJ
الوزراء	NOUN
يتشاورون	VERB
حول	ADP
كيفية	NOUN
التدخل	NOUN
لوقف	NOUN
انخفاض	NOUN
الاسعار	NOUN
بشكل	NOUN
اكبر	ADJ
.	PUNCT

توجه	VERB
فريق	NOUN
خاص	ADJ
من	ADP
صحفيى	NOUN
وكالة	NOUN
انباء	NOUN
شينخوا	X
بعد	ADP
ظهر	NOUN
اليوم	NOUN
الى	ADP
احدى	NOUN
المستشفيات	NOUN
بغرب	NOUN
بكين	X
خصصت	VERB
لعلاج	NOUN
عرض	NOUN
الالتهاب	NOUN
الرئوى	ADJ
الحاد	ADJ
/	PUNCT
سارس	X
/	PUNCT
.	PUNCT

الرئيس	NOUN
التنفيذى	ADJ
لهونج	X
كونج	X
يتفقد	VERB
الإجراءات	NOUN
الوقائية	ADJ
ضد	ADP
السارس	X

ظلت	VERB
أسعار	NOUN
الخضروات	X
ثابتة	ADJ
.	PUNCT
وقام	VERB
سوق	NOUN
شينفادى	X
،	PUNCT
أكبر	ADJ
سوق	NOUN
خضروات	X
فى	ADP
المدينة	NOUN
،	PUNCT
بطرح	NOUN
7.15	NUM
مليون	NUM
كيلوجرام	NOUN
من	ADP
الخضروات	X
للبيع	NOUN
كل	NOUN
يوم	NOUN
خلال	ADP
عطلة	NOUN
عيد	X
العمال	NOUN
بزيادة	NOUN
38	NUM
فى	ADP
المائة	NUM
مقارنة	NOUN
بالفترة	NOUN
ذاتها	NOUN
من	ADP
العام	NOUN
الماضى	ADJ
.	PUNCT

توقفت	VERB
محادثات	NOUN
السلام	NOUN
بين	ADP
الحكومة	NOUN
وجبهة	NOUN
نمور	X
تحرير	NOUN
ايلام	X
التاميلية	X
التى	DET
تمت	VERB
بوساطة	NOUN
نرويجية	ADJ
،	PUNCT
منذ	ADP
قرر	VERB
المتمردون	NOUN
تعليق	NOUN
المحادثات	NOUN
مع	ADP
الحكومة	NOUN
يوم	NOUN
21	NUM
ابريل	NOUN
.	PUNCT
